................
.......##.......
..#..........#..
..#..#....#..#..
.....#....#.....
..#....##....#..
..#..........#..
................
..#....##....#..
..#..#....#..#..
.....#....#.....
................