................
................
...###....###...
...#........#...
................
.....#....#.....
.....#....#.....
..#..##..##..#..
..#..........#..
..###......###..
.......##.......
................