................
................
...####..####...
...#........#...
...#........#...
.......##.......
.......##.......
...#........#...
...#........#...
...####..####...
................
................